aeronáutica = Aeronáutica
agricultura = Agricultura
ajedrez = Ajedrez
algas = Algas
álgebra = Matemáticas
alimentos = Alimentos
alpinismo = Alpinismo
alquimia = Alquimia
anatomía = Anatomía
anélidos = Anélidos
anfibios = Anfibios
angiología = Angiología
animales = Animales
antropología = Antropología
antropotomía = Antropotomía
apicultura = Apicultura
arácnidos = Arácnidos
árboles = Árboles
aritmética = Matemáticas
armamento = Armamento
armas = Armas
arqueología = Arqueología
arquitectura = Arquitectura
arte = Artes
artes marciales = Artes marciales
artrópodos = Artrópodos
astrofísica = Astrofísica
astrología = Astrología
astronomía = Astronomía
atletismo = Atletismo
audiología = Audiología
automovilismo = Automovilismo
aves = Aves
baloncesto = Baloncesto
bebida = Bebidas
béisbol = Béisbol
billar = Billar
biología = Biología
bioquímica = Bioquímica
bolos = Bolos
botánica = Botánica
cardiología = Cardiología
carpintería = Carpintería
cerrajería = Cerrajería
cetrería = Cetrería
ciclismo = Ciclismo
ciencia = Ciencia
ciencia ficción = Ciencia ficción
cine = Cine
cinegética = Cinegética
cinología = Cinología
cirugía = Cirugía
ciudades = Ciudades, Topónimos
colores = Colores
comercio = Comercio
constelaciones = Constelaciones
construcción = Construcción
contabilidad = Contabilidad
continentes = Continentes, Topónimos
cosmética = Cosmética
cosmología = Cosmología
costura = Costura
cristianismo = Cristianismo
cronología = Tiempo cronológico
crustáceos = Crustáceos
cubertería = Cubertería
cultura = Cultura
danza = Danza
deporte = Deporte
derecho = Derecho
dinosaurios = Dinosaurios
diseño = Diseño
ecología = Ecología
economía = Economía
edafología = Edafología
educación = Educación
electricidad = Electricidad
electrónica = Electrónica
elementos químicos = Elementos químicos
enfermedades = Enfermedades
enología = Enología
enseñanza = Enseñanza
entomología = Entomología
equitación = Equitación
escultura = Escultura
esgrima = Esgrima
especias = Especias
estadística = Estadística
estomatología = Estomatología
ética = Ética
farmacología = Farmacología
fármacos = Fármacos
ficción = Ficción fantástica
filatelia = Filatelia
filosofía = Filosofía
finanzas = Finanzas
física = Física
fisiología = Fisiología
flores = Flores
folclore = Folclore
fonética = Fonética
fotografía = Fotografía
frutas = Frutas
frutos = Frutos
fútbol = Fútbol
ganadería = Ganadería
gastronomía = Gastronomía
genética = Genética
gentilicios = Gentilicios
geografía = Geografía
geología = Geología
geometría = Geometría
gimnasia = Gimnasia
guarismos = Guarismos
heráldica = Heráldica
herramientas = Herramientas
historia = Historia
historieta = Historieta
hockey sobre césped = Hockey sobre césped
hongos = Hongos
horticultura = Horticultura
huesos = Huesos
ictiología = Ictiología
imprenta = Imprenta
industria = Industria
informática = Informática
ingeniería = Ingeniería
inmunología = Inmunología
insectos = Insectos
instrumentos musicales = Instrumentos musicales
invertebrados = Invertebrados
islam = Islam
islas = Islas, Topónimos
juegos = Juego
lagos = Lagos, Topónimos
lenguas = Lenguas
lingüística = Lingüística
literatura = Literatura
lógica = Lógica
logística = Logística
lucha = Lucha
malabarismo = Malabarismo
mamíferos = Mamíferos
mares = Mares, Topónimos
matemáticas = Matemáticas
mecánica = Mecánica
medicina = Medicina
meses = Meses
metalurgia = Metalurgia
meteorología = Meteorología
metrología = Metrología
micología = Micología
microbiología = Microbiología
milicia = Milicia
minerales = Minerales
mineralogía = Mineralogía
minería = Minería
mitología = Mitología
mobiliario = Mobiliario
moluscos = Moluscos
monedas = Monedas
música = Música
naipes = Naipes
natación = Natación
náutica = Náutica
nemátodos = Nemátodos
neurología = Neurología
números = Números
numismática = Numismática
nutrición = Nutrición
ocultismo = Ocultismo
ocupaciones = Ocupaciones
odontología = Odontología
oftalmología = Oftalmología
óptica = Óptica
ornitología = Ornitología
países = Países, Topónimos
paleontología = Paleontología
peces = Peces
periodismo = Periodismo
pesca = Pesca
pintura = Pintura
planetas = Planetas
plantas = Plantas
platelmintos = Platelmintos
platos = Platos
poblaciones = Poblaciones, Topónimos
poesía = Poesía
política = Política
psicología = Psicología
psiquiatría = Psiquiatría
química = Química
regiones = Topónimos
religión = Religión
relojería = Relojería
reptiles = Reptiles
retórica = Retórica
ríos = Ríos, Topónimos
rugby = Rugby
sabores = Sabores
sexualidad = Sexualidad
silvicultura = Silvicultura
sociología = Sociología
tauromaquia = Tauromaquia
teatro = Teatro
tecnología = Tecnología
telecomunicación = Telecomunicación
tenis = Tenis
termodinámica = Termodinámica
textiles = Textiles
tipografía = Tipografía
topónimos = Topónimos
transporte = Transporte
tribus urbanas = Tribus urbanas
utensilios = Utensilios
vegetales = Vegetales
vehículos = Vehículos
verduras = Verduras
vestimenta = Vestimenta
veterinaria = Veterinaria
vivienda = Vivienda
zoología = Zoología
zootomía = Zootomía
