# TODO: expand per [[Especial:TodasLasRedirecciones]], delete obsolete templates

Pronunciación = pronunciación
Etimología = etimología
etimologia = etimología
etyl = etimología
Desambiguación = desambiguación
Desambiguacion = desambiguación
desambiguacion = desambiguación
desamb = desambiguación
Desambig = desambiguación
Notadesambiguación = desambiguación
Desambiguado = desambiguación
grafías alternativas = grafía alternativa
ucf = plm
Anagramas = anagrama
Parónimos = parónimo
tit ref = título referencias
sustantivo masculino y femenino = sustantivo femenino y masculino
acrónimo = sigla
redireccion suave = redirección suave

Ampliable = ampliable
Definición = definición
Discutido = discutido
Stub = esbozo
stub = esbozo
Esbozo = esbozo
Formato = estructura
formato = estructura
revisar = revisión

DRAE1914 = DLC1914
DUE = MaríaMoliner
Moliner = MaríaMoliner
NDLC1866 = Labernia1866
dlc1914 = DLC1914
dme1831 = DME1831
dme1864 = DME1864
dp2002 = DP2002
drae1914 = DLC1914

# TODO: these are not transcluded, analyze "leng" params instead

aka = ak
allentiac = qbt
arg = an
aus-dar = 0hk
ava = av
ave = ae
bak = ba
bam = bm
bat-smg = sgs
be-x-old = be
bod = bo
ces = cs
cha = ch
che = ce
chu = cu
chv = cv
cor = kw
cos = co
cre = cr
cym = cy
div = dv
ewe = ee
fas = fa
fiu-vro = vro
ful = ff
gkm = qgk
gla = gd
gle = ga
glv = gv
her = hz
hmo = ho
hrv = hr
hye = hy
ind = id
jav = jv
kal = kl
kat = ka
lzh = zh-classical
mah = mh
mlt = mt
mri = mi
nb = no
nrm = nrf
oji = oj
ood = nai
protoindoeuropeo = ine
prv = oc
roa-oca = oca
roa-rup = rup
roa-tara = roa-tar
roh = rm
sna = sn
srd = sc
srp = sr
ssw = ss
tsz = pua
yue = zh-yue
zh-cn = zh
zh-min-nan = nan
zh-wuu = wuu

AR = AR-ES
CA = CA-ES
CHN = CMN-ES
EN = EN-ES
EU = EU-ES
FR = FR-ES
GL = GL-ES
IT = IT-ES
LA = LA-ES
MN = MN-ES
PL = PL-ES
PT = PT-ES
QU = QU-ES

Allentiac-ES = QBT-ES
BAT-SMG-ES = SGS-ES
CYM-ES = CY-ES
FIU-VRO-ES = VRO-ES
FRS-ES = STQ-ES
LZH-ES = ZH-CLASSICAL-ES
MYA-ES = MY-ES
NLD-ES = NL-ES
OFR-ES = FRO-ES
PROTOPOLINESIO-ES = POZ-POL-ES
Protopolinesio-ES = POZ-POL-ES
PRV-ES = OC-ES
TGL-ES = TL-ES
TOG-ES = TO-ES
TSZ-ES = PUA-ES
YUE-ES = ZH-YUE-ES
ZH-ES = CMN-ES

Indoeuropeo = INE-ES
castellanoantiguo = OSP-ES
Aymará-Español = AY-ES
Guaraní-Español = GN-ES
Náhuatl-Español = NAH-ES
Quechua-Español = QU-ES

Caracter oriental = Carácter oriental
